NO ./textures/north.xpm
SO ./textures/south.xpm
WE ./textures/west.xpm
EA ./textures/east.xpm

F 220,                          100,            0
C 225,30,0

        1111111111111111111111111
        1000000000110000000000001
        1011000001110000000000001
        1001000000000000000000001
111111111011000001110000000000001
100000000011000001110111111111111
1111011111111101111111100000010001
111101111111110111    101010010001
1100000011010101111111110010001
1000000000000000110000001000111
10000000000000001101010010001
11000001110101011111011110N0111111
11110111 1110101 101111010001
11111111 1111111 111111111111