WE ./src/assets/textures/sw_1.xpm
NO      ./src/assets/textures/sw_2.xpm

SO ./src/assets/textures/sw_3.xpm 
EA ./src/assets/textures/sw_4.xpm




F 50,   50, 50
C 100,100,100


       


        1111111111111111111111111
        1000000000110000000000001
        1011000001110000010000001
        1001000000000000N00000001
111111111011000001110000000000001
100000000011000001110111111111111
1111011111111101111111100000010001
111101111111110111    101010010001
1100000011010101111111110010001111
1000000000000000110000001000111
10000000000000001101010010001
11000001110101011111011110011111
11110111 1110101 101111010001
11111111 1111111 111111111111
